...############################.
#.............#.......#........#
#.###.#.#####.#.#####.#.######.#
#.....#.......#.....#..........#
#####.#.#.###.###.###.#.#.####.#
#...#...#...#.......#.#........#
#.###.###.#.#.#.##.#.#.#####.#.#
#.....#...#.#.#..#...#.....#...#
#.###.###.#.#.##.#####.###.#.#.#
#...........#......#.....#...#.#
#.#####.#.###.#.##.#.#####.#.#.#
#.#...#.......#.#..#.....#.#...#
#.###.#######.##.#.#####.#.###.#
#...#.......#....#.....#.......#
#.#.#####.#.######.###.#.#####.#
#...#...#.#.......#...#.#.....#.
#####.#.#.###.#####.#.#.#####.#.
#.........#.......#.#.........#.
###....####..#####...#######....